wwwwww
wFFFww
wwFFFw
wFFFww
wwFFFw
wFFFww
wwpFFw
wwwwww