wwwwwwwwwwww
wwwFFFFFFFFw
wwwFFFFFFFww
wFFFFFFFFwww
wwwwFFFFFFww
wwwwwFFFFFFw
wwwFFFFFFwww
wFFFFFFFFwww
wwFFFFFFwwww
wwwwFFFFFFFw
wwwFFFFFFFFw
wFFFFFFFFwww
wpFFFFFFFwww
wwwwwwwwwwww