wwwwwwwwwwww
wFFFFFFFFwww
wwwwFFFFFFww
wwwwwFFFFFFw
wwFFFFFFFFFw
wwFFFFFFFFFw
wwFFFFFFFFFw
wwFFFFFFFFww
wwFFFFFFFwww
wFFFFFFwwwww
wFFFFFFFFFww
wFFFFFFwwwww
wwpFFFFFFFww
wwwwwwwwwwww